79 79 79 79 79 79 79 79 79 79 79 79 79 79 79 79 79 79 79 79 79 79 79 5 79 79 79 79 79 79 79 79 79 79 79 79 5 79 79 79 79 79 79 79 79 79 79 79 79 79 79 79 79 79 79 79 79 79 79 79 79 79 79 79 79 79 79 79 8 79 79 79 79 79 79 79 79 79 79 79 
79 45 45 45 45 16 79 26 79 79 79 16 79 79 79 79 79 79 79 5 79 79 44 79 79 79 17 79 79 79 79 5 79 79 79 17 79 79 79 79 79 79 79 79 79 17 79 79 79 79 79 79 79 79 79 79 79 79 17 79 79 79 79 8 79 79 79 79 79 79 79 79 79 79 79 79 79 79 79 79 
45 45 79 27 79 16 79 45 79 79 16 79 79 79 79 79 79 79 79 79 79 79 79 79 79 79 79 79 79 29 79 45 45 45 45 45 45 45 45 45 45 45 17 79 79 79 79 79 5 27 5 79 27 79 79 5 79 79 79 79 79 79 79 79 79 26 79 8 79 79 79 79 26 79 79 28 79 79 29 79 
79 79 79 79 27 79 45 79 79 79 79 79 27 79 79 79 44 79 79 79 45 28 45 27 79 79 79 79 79 79 79 29 28 79 29 79 28 29 28 29 79 79 79 26 79 79 79 29 29 79 79 79 79 29 28 29 28 29 29 45 45 45 45 79 17 79 79 79 79 79 79 79 79 79 79 5 79 79 79 79 
79 79 79 79 79 79 79 79 79 79 79 26 79 79 79 79 79 79 44 45 28 28 79 79 79 79 5 79 79 79 79 27 16 27 16 79 27 79 29 28 79 79 79 79 79 29 5 5 79 79 79 28 79 79 79 79 79 79 79 79 45 79 8 79 79 79 16 79 79 27 79 79 79 79 79 79 79 79 79 79 
22 22 22 22 22 22 22 22 22 22 79 79 79 16 79 79 44 44 44 79 29 79 79 79 27 79 5 5 16 79 79 79 79 79 79 16 79 79 79 79 79 28 28 29 79 79 79 29 79 79 79 44 44 44 5 45 45 16 16 79 79 18 79 27 79 45 79 16 45 45 45 45 79 27 79 79 79 79 79 79 
22 22 22 22 22 22 22 22 22 22 22 79 79 79 79 79 44 79 79 79 79 79 79 79 79 5 16 29 79 17 79 79 26 79 79 79 79 79 79 79 79 79 79 79 79 26 17 79 79 45 45 29 26 5 29 29 79 79 29 79 79 79 79 79 79 79 18 79 79 44 79 79 79 79 79 8 26 79 45 45 
22 22 22 22 22 22 22 22 22 22 22 22 79 79 79 79 79 79 79 79 79 29 79 79 16 79 29 28 79 79 79 79 79 5 79 8 79 79 26 28 79 79 45 45 79 17 79 79 29 79 79 79 79 79 79 79 79 79 79 8 79 8 79 18 79 79 79 79 79 79 79 79 79 79 79 79 79 79 79 79 
22 22 22 22 22 22 22 22 22 22 22 22 79 79 79 79 79 79 45 44 79 79 79 79 16 16 44 79 79 26 79 45 79 28 79 79 29 79 45 45 45 45 44 79 29 79 79 79 79 79 16 79 16 79 79 17 79 79 79 18 79 79 79 16 8 79 18 26 45 79 26 79 79 79 79 79 79 79 79 79 
22 22 22 22 22 22 22 22 22 22 22 22 22 79 79 79 79 79 79 79 28 79 27 45 79 79 79 79 79 16 5 16 16 27 79 79 79 79 79 29 79 79 79 44 44 44 27 79 27 79 79 79 29 79 79 79 79 79 16 79 16 8 79 79 79 79 79 79 79 79 79 79 44 44 44 79 79 79 27 79 
22 22 22 22 22 22 22 22 22 22 22 22 22 22 79 79 79 79 79 79 79 79 79 79 45 45 45 45 45 45 79 79 79 79 8 79 79 5 5 79 79 79 79 16 79 79 16 44 44 79 79 79 79 79 79 79 26 79 79 79 79 79 79 44 44 44 79 79 79 79 79 79 5 79 79 44 44 44 79 79 
22 22 22 22 22 22 22 22 22 22 22 22 22 22 22 79 79 79 79 79 79 79 79 79 79 79 79 79 79 79 79 79 79 79 79 79 79 79 79 79 79 79 79 79 79 79 79 79 79 44 79 17 29 79 79 44 44 44 44 44 44 44 44 79 79 79 79 79 79 26 79 79 44 79 8 79 27 79 79 79 
22 22 22 22 22 22 22 22 22 22 22 22 22 22 22 22 22 22 22 22 22 22 22 22 22 22 22 22 22 22 22 22 22 22 22 22 22 22 22 22 22 22 22 22 22 79 79 79 79 79 79 79 29 79 79 79 79 22 22 22 22 22 22 22 22 22 79 79 79 79 79 79 79 79 79 79 79 79 79 79 
22 22 22 22 22 22 22 22 22 22 22 22 22 22 22 22 22 22 22 22 22 22 22 22 22 22 22 22 22 22 22 22 22 22 22 22 22 22 22 22 22 22 22 22 22 22 22 79 79 79 79 5 79 79 79 79 22 22 22 22 22 22 22 22 22 22 22 79 79 79 79 79 79 79 79 79 79 26 44 79 
79 4 79 4 4 79 22 22 22 22 22 22 22 22 22 22 22 22 22 22 22 22 22 22 22 22 22 22 22 22 22 22 22 22 22 22 22 22 22 22 22 22 22 22 22 22 22 22 79 79 79 79 79 79 22 22 22 22 22 22 22 22 22 22 22 22 22 79 79 79 26 79 79 79 8 79 79 79 79 79 
79 79 79 79 79 79 79 22 22 22 22 22 22 22 22 22 22 22 22 22 22 22 22 22 22 22 22 22 22 22 22 22 22 22 22 22 22 22 22 22 22 22 22 22 22 22 22 22 22 22 22 22 22 22 22 22 22 22 22 22 22 22 22 22 22 22 22 22 22 22 79 79 79 79 79 79 79 79 79 79 
4 79 79 79 79 79 79 79 22 22 22 22 22 22 22 22 22 22 22 22 22 22 22 22 22 22 22 22 22 22 22 22 22 22 22 22 22 22 22 22 22 22 22 22 22 22 22 22 22 22 22 22 22 22 22 22 22 22 22 22 22 22 22 22 22 22 22 22 22 22 22 22 22 79 79 79 8 79 79 79 
4 79 79 79 79 79 79 79 79 22 22 22 22 22 22 22 22 22 22 22 22 22 22 22 22 22 22 22 22 22 22 22 22 22 22 22 22 22 22 22 22 22 22 22 22 22 22 22 22 22 22 22 22 22 22 22 22 22 22 22 22 22 22 22 22 22 22 22 22 22 22 22 22 22 22 22 79 79 79 79 
79 79 79 79 16 79 4 79 79 79 79 79 79 79 79 79 22 22 22 22 22 22 22 22 22 22 22 22 22 22 22 22 22 22 22 22 22 22 22 22 22 22 22 22 22 22 22 22 22 22 22 22 22 22 22 22 22 22 22 22 22 22 22 22 22 22 22 22 22 22 22 22 22 22 22 22 22 22 79 79 
79 79 79 79 79 79 79 79 79 79 79 79 79 79 79 79 66 79 79 79 79 79 22 22 22 22 22 22 22 22 22 22 22 22 22 22 22 22 22 22 22 22 22 22 22 22 22 22 22 22 22 22 22 22 22 22 22 22 22 22 22 22 22 22 22 22 22 22 22 22 22 22 22 22 22 22 22 22 22 22 
79 79 79 79 79 28 79 16 79 17 66 28 79 79 79 66 79 79 79 79 79 79 79 79 79 79 22 22 22 22 22 22 22 22 22 22 22 22 22 22 22 22 22 22 22 22 22 22 22 22 22 22 22 22 22 22 22 22 22 22 22 22 22 22 22 22 22 22 22 22 22 22 22 22 22 22 22 22 22 22 
79 79 79 79 29 79 79 29 79 79 79 79 79 79 79 79 79 79 79 28 16 79 79 79 79 79 79 79 79 79 79 22 22 22 22 22 22 22 22 22 22 22 22 22 22 22 22 22 22 22 22 22 22 22 22 22 22 22 22 22 22 22 22 22 22 22 22 22 22 22 22 22 22 22 22 22 22 22 22 22 
79 4 79 79 79 79 79 79 79 79 26 37 38 38 38 39 45 79 4 79 79 79 79 28 79 79 79 79 79 79 79 22 22 22 22 22 22 22 22 22 22 22 22 22 22 22 22 22 22 22 22 22 22 22 22 22 22 22 22 22 22 22 22 22 22 22 22 22 22 22 22 22 22 22 22 22 22 22 22 22 
79 16 79 79 28 79 79 79 66 79 37 48 48 48 48 48 39 79 29 79 79 79 29 79 79 29 79 79 79 79 79 22 22 22 22 22 22 22 22 22 22 22 22 22 22 22 22 22 22 22 22 22 22 22 22 22 22 22 22 22 22 22 22 22 22 22 22 22 22 22 22 22 22 22 22 22 22 22 22 22 
79 79 28 4 79 79 29 79 79 79 47 48 48 48 48 48 49 79 79 79 29 79 79 16 79 79 4 79 79 79 79 79 22 22 22 22 22 22 22 22 22 22 22 22 22 22 22 22 22 22 22 22 22 22 22 22 22 22 22 22 22 22 22 22 22 22 22 22 22 22 22 22 22 22 22 22 22 22 22 22 
79 29 79 4 79 28 79 79 79 66 47 48 48 48 48 48 49 16 79 16 28 79 79 29 79 79 29 79 79 79 79 79 22 22 22 22 22 22 22 22 22 22 22 22 22 22 22 22 22 22 22 22 22 22 22 22 22 22 22 22 22 22 22 22 22 22 22 22 22 22 22 22 22 22 22 22 22 22 22 22 
16 79 79 79 79 79 16 79 79 79 57 47 48 48 48 48 59 79 79 79 79 79 4 4 79 79 79 16 79 79 79 79 22 22 22 22 22 22 22 22 22 22 22 22 22 22 22 22 22 22 22 22 22 22 22 22 22 22 22 22 22 22 22 22 22 79 79 79 79 79 79 22 22 22 22 22 22 22 22 22 
79 79 16 79 29 79 29 79 28 79 79 57 58 58 58 59 79 4 16 79 79 16 79 79 79 28 79 79 79 79 79 22 22 22 22 22 22 22 22 22 22 22 22 22 22 22 22 22 22 22 22 22 22 22 22 22 22 22 22 22 22 22 22 79 79 79 16 79 28 79 79 79 16 79 79 79 79 79 79 79 
79 79 28 79 79 79 79 4 79 79 79 79 79 66 79 79 16 79 79 79 79 79 4 79 79 79 79 79 79 79 79 22 22 22 22 22 22 22 22 22 22 22 79 79 79 79 79 79 79 79 79 79 79 79 22 22 22 22 22 22 22 22 22 79 79 97 98 98 98 98 98 98 98 98 98 98 98 98 99 79 
79 79 4 79 16 79 79 79 79 79 79 79 79 79 79 79 79 29 79 4 79 79 79 79 79 16 79 29 79 79 22 22 22 22 22 22 22 22 79 79 79 79 79 79 79 79 79 79 79 79 79 79 79 79 79 22 22 22 22 22 22 22 22 79 79 107 108 108 108 108 108 108 108 108 108 108 108 108 109 79 
4 4 79 79 79 79 4 4 79 67 68 68 68 68 68 68 68 79 79 79 29 79 79 79 79 79 79 79 79 79 22 22 22 22 22 22 22 22 79 79 79 79 79 44 44 44 44 44 44 79 79 79 79 79 79 22 22 22 22 22 22 22 22 79 79 107 108 108 108 108 108 108 108 108 108 108 108 108 109 79 
4 79 79 79 4 4 79 79 79 79 4 79 79 79 79 79 79 29 79 79 79 4 4 79 79 79 79 4 79 22 22 22 22 22 22 22 22 79 79 79 44 44 44 44 44 44 44 44 44 44 79 79 79 79 79 79 22 22 22 22 22 22 22 79 79 107 108 108 108 108 108 108 108 108 108 108 108 108 109 79 
79 79 79 79 79 79 79 79 79 79 79 79 79 79 79 4 4 79 79 79 79 79 79 79 79 79 79 79 79 22 22 22 22 22 22 22 22 79 79 44 44 44 16 79 79 79 16 79 79 79 79 79 79 79 79 79 22 22 22 22 22 22 22 79 79 107 108 108 108 108 108 108 108 108 108 108 108 108 109 79 
79 79 79 22 22 22 22 22 22 22 22 22 22 22 22 22 22 22 22 22 22 22 22 22 22 22 22 22 22 22 22 22 22 22 22 22 79 79 44 44 44 79 79 79 29 79 79 19 79 79 79 79 79 79 79 79 22 22 22 22 22 22 22 79 79 107 108 108 108 108 108 108 108 108 108 108 108 108 109 79 
79 79 79 22 22 22 22 22 22 22 22 22 22 22 22 22 22 22 22 22 22 22 22 22 22 22 22 22 22 22 22 22 22 22 22 79 79 44 44 79 79 79 79 79 16 79 79 79 44 44 44 79 79 79 79 79 22 22 22 22 22 22 22 79 79 107 108 108 108 108 108 108 108 108 108 108 108 108 109 79 
22 22 22 22 22 22 22 22 22 22 22 22 22 22 22 22 22 22 22 22 22 22 22 22 22 22 22 22 22 22 22 22 22 22 22 79 79 44 44 79 79 79 79 44 44 44 44 44 44 79 19 44 79 79 79 79 22 22 22 22 22 22 22 79 79 107 108 108 108 108 108 108 108 108 108 108 108 108 109 79 
22 22 22 22 22 22 22 22 22 22 22 22 22 22 22 22 22 22 22 22 22 22 22 22 22 22 22 22 22 22 22 22 22 22 79 79 44 79 44 79 16 79 79 44 44 79 79 79 79 79 44 44 16 79 79 79 22 22 22 22 22 22 22 79 79 107 108 108 108 108 108 108 108 108 108 108 108 108 109 79 
22 22 22 22 22 22 22 22 22 22 22 22 22 22 22 22 22 22 22 22 22 22 22 22 22 22 22 22 22 22 22 22 22 22 79 44 44 79 44 79 79 79 79 79 79 79 79 44 44 44 44 79 79 79 79 22 22 22 22 22 22 22 22 79 79 107 108 108 108 108 108 108 108 108 108 108 108 108 109 79 
22 22 22 22 22 22 22 22 22 22 22 22 22 22 22 22 22 22 22 22 22 22 22 22 22 22 22 22 22 22 22 22 22 79 44 44 79 16 79 44 44 79 79 44 44 44 44 79 79 79 79 79 79 79 79 22 22 22 22 22 22 22 22 79 79 107 108 108 108 108 108 108 108 108 108 108 108 108 109 79 
22 22 22 22 22 22 22 22 22 22 22 22 22 22 22 22 22 22 22 22 22 22 22 22 22 22 22 22 22 22 22 22 22 79 44 79 79 79 79 79 79 44 44 44 79 79 79 79 79 79 79 79 79 79 22 22 22 22 22 22 22 22 79 79 79 107 108 108 108 108 108 108 108 108 108 108 108 108 109 79 
22 22 22 22 22 22 22 22 22 22 22 22 22 22 22 22 22 22 22 22 22 22 22 22 22 22 22 22 22 22 22 79 79 44 44 18 79 79 79 79 28 79 44 44 44 44 44 44 44 44 44 79 79 22 22 22 22 22 22 22 22 22 79 79 79 107 108 108 108 108 108 108 108 108 108 108 108 108 109 79 
22 22 22 22 22 79 79 79 79 79 79 79 79 79 79 79 79 79 79 79 79 79 79 22 22 22 22 22 79 79 79 79 79 44 79 79 79 79 79 79 44 44 44 44 44 44 44 44 44 79 79 79 22 22 22 22 22 22 22 22 22 22 79 79 79 107 108 108 108 108 108 108 108 108 108 108 108 108 109 79 
22 22 22 79 79 79 79 79 79 79 79 79 79 79 79 79 79 79 79 79 79 79 79 79 79 79 79 79 79 29 79 44 44 44 79 79 44 44 44 44 44 44 44 44 44 79 79 79 79 22 22 22 22 22 22 22 22 22 22 22 22 22 79 79 79 107 108 108 108 108 108 108 108 108 108 108 108 108 109 79 
79 79 45 79 79 79 29 79 79 44 44 79 79 79 79 79 79 79 79 26 79 79 79 79 79 44 44 44 44 44 44 44 44 44 44 44 44 79 44 44 44 79 79 16 79 16 16 79 79 22 22 22 22 22 22 22 22 22 22 22 22 79 79 79 79 107 108 108 108 108 108 108 108 108 108 108 108 108 109 79 
79 79 16 45 28 45 79 79 44 79 79 79 79 79 45 45 79 79 44 26 44 79 44 44 44 44 79 79 79 79 44 44 44 79 44 44 44 16 44 79 79 79 79 79 79 79 79 79 79 22 22 22 22 22 22 22 22 22 22 22 79 79 79 79 79 107 108 108 108 108 108 108 108 108 108 108 108 108 109 79 
79 79 45 16 28 79 79 79 44 28 28 79 79 29 44 44 44 79 79 45 28 44 44 79 79 79 79 79 44 28 44 79 79 79 79 79 44 44 44 79 79 79 79 79 79 79 79 79 79 22 22 22 22 22 22 22 22 22 22 79 79 45 16 45 79 117 118 118 118 118 118 118 118 118 118 118 118 118 119 79 
79 16 79 79 79 79 79 79 44 44 44 79 79 79 44 29 26 44 44 79 79 79 79 44 44 44 44 28 29 79 79 79 79 44 44 44 44 79 44 44 79 79 79 79 79 79 79 79 22 22 22 22 22 22 22 22 22 22 79 79 79 79 79 45 79 79 79 79 79 19 19 79 79 79 79 16 79 79 79 79 
79 79 79 29 79 79 16 45 26 29 79 44 44 44 26 26 16 79 44 79 44 44 44 79 79 79 44 44 44 44 44 44 44 79 79 79 79 16 79 44 44 44 79 79 79 17 79 79 22 22 22 22 22 22 22 22 22 22 79 79 79 16 79 45 79 29 79 79 79 79 79 79 79 79 45 79 79 29 79 79 
79 45 79 79 79 79 45 45 16 79 79 79 79 45 79 79 79 79 44 44 44 79 79 79 79 79 79 79 79 79 79 79 79 79 79 79 79 79 79 79 79 44 44 44 44 44 79 79 22 22 22 22 22 22 22 22 22 22 79 28 45 79 79 79 79 79 28 79 45 45 45 45 79 45 45 45 79 79 79 79 
79 79 79 79 79 16 79 28 16 79 79 79 79 79 79 79 79 79 79 79 79 79 79 79 79 79 29 79 79 79 79 79 79 79 79 79 79 79 79 79 79 79 79 79 79 79 79 79 22 22 22 22 22 22 22 22 22 22 79 79 79 79 79 29 79 79 79 79 16 79 79 28 79 79 79 79 79 79 16 79 

